4,4,4,4,4,4,4,4,4,4,4,5,4,4,4,4,4,4,4,4
4,4,4,4,4,4,4,4,4,4,4,4,4,4,4,4,4,4,4,4
4,4,4,4,4,4,5,4,4,5,4,5,4,4,4,4,4,4,4,4
4,4,4,4,4,4,5,4,5,5,5,5,4,4,4,4,4,4,4,4
4,4,4,4,4,5,4,4,5,5,5,5,5,5,4,4,4,4,4,4
4,4,4,4,4,5,4,5,5,5,5,5,5,5,4,4,4,4,4,4
4,4,4,4,4,4,4,4,5,5,5,0,5,4,4,4,4,4,4,4
4,4,4,4,4,4,4,5,5,5,0,1,4,4,4,4,4,4,4,4
4,4,4,4,4,4,4,4,4,5,0,1,1,3,4,4,4,4,4,4
4,4,4,4,3,5,5,5,4,5,5,3,3,5,4,4,4,4,4,4
4,4,4,4,3,5,5,5,4,4,4,5,5,5,5,4,4,4,4,4
4,4,5,5,3,3,3,4,4,4,4,4,5,5,5,5,4,4,4,4
4,4,5,5,5,0,1,4,4,4,4,4,5,5,5,5,5,4,4,4
4,4,4,5,5,5,0,4,4,4,5,5,5,5,5,5,5,4,4,4
4,4,5,5,5,5,5,4,4,4,5,5,5,5,5,5,5,5,5,4
4,4,5,5,5,4,4,4,4,5,5,5,5,5,5,1,1,0,5,4
4,4,4,4,4,4,4,4,4,4,4,5,5,5,5,0,0,5,4,4
4,4,4,4,4,4,4,4,4,4,5,5,5,5,5,5,5,4,4,4
4,4,4,4,4,4,4,4,5,5,5,5,4,4,4,4,4,4,4,4
4,4,4,4,4,4,4,4,4,4,4,4,4,4,4,4,4,4,4,4
